##################################################
#..#........................#..#....#......#.....#
#..#.###################....#.......#......#.....#
#..#.#.................#....#..#....#......#.###.#
#......###....###......#....#..#....#......#.....#
####.#.....@....###....######..#..########.#.....#
#......###....###................................#
#.##...................#########..###########..###
#....###################..............#.....#....#
#..........#.........#.#...#....#.....#.....#....#
#########..#..##..##.#.#####....#...........###..#
#..........#...........#...#....#...#########....#
#.##########....##..##.#........#####............#
#..#...#.#####.......#.#####........#....#####...#
#......#.....#..###..#.......#####..#....#...#...#
#####.##.....#.......#.#####.#......#....#.......#
#............#.#####.#.#........#####.########...#
#.###..#.########..#.#.######.......#....#...#...#
#......#.#...........#..............#....#.......#
##################################################