##################################################
#..#........................#..#....#......#.....#
#..#.###################....#.......#......#.....#
#..#.#.................#....#..#....#......#.###.#
#......###....###..A...#....#..#....#......#.....#
####.#.....@....###....######..#..########.#.....#
#......###....###................................#
#.##...................#########..###########..###
#....###################..............#.....#....#
#.....B....#.........#.#...#....#.....#.....#....#
#########..#..##..##.#.#####....#...........###..#
#..........#......A....#...#....#...#########....#
#.##########....##..##.#........#####............#
#..#...#.#####.......#.#####........#....#####...#
#......#.B...#..###..#.......#####..#....#...#...#
#####.##.....#.......#.#####.#......#....#.......#
#............#.#####.#.#........#####.########...#
#.###..#.########..#.#.######.......#....#...#...#
#......#.#...........#..............#....#.......#
##################################################