##################################################
#..#........................#..#....#......#.....#
#..#.###################....#.....A.#......#.....#
#..#.#.................#....#..#....#..B...#.###.#
#......###....###..A...#....#..#....#......#.....#
####.#.....@....###....######..#..########.#.....#
#......###....###..B.............................#
#.##...................#########..###########..###
#....###################......A.......#.....#....#
#.....B....#.........#.#...#....#.....#.....#....#
#########..#..##..##.#.#####....#......A....###..#
#..........#......A....#...#..A.#...#########....#
#.##########....##..##.#........#####..A.........#
#..#...#.#####.......#.#####........#....#####...#
#......#.B...#..###..#.......#####..#....#...#...#
#####.##.....#.......#######.#......#..A.#.......#
#............#.#####.#<#......B.#####.########...#
#.###..#.########..#.#A######.......#....#...#...#
#......#.#...........#AAA...........#....#.......#
##################################################