##################################################
#@..#............................................#
#..#......#......................................#
#.#..............................................#
#..............................###########.......#
#................................................#
#................................................#
#........................................#####..##
#.......................................#...##...#
#........................................##...####
#..........#####.................................#
#.........#########..........................#.#.#
#..........##......#########.....................#
#$........######..#..............................#
#................................................#
#..........................#######################
#....########..............######................#
#................................................#
#......###################.......................#
##################################################
