##################################################
#@..#..#.......A..........#................##....#
#..#......#...........#.......##......#..........#
#.#...##...........##...................#...B....#
#.......##.....##.......##.....###########.......#
#............#....#.##.....##.........#..........#
#...A...#.##............................##.......#
#........#.....#....#######.....##..#....#####..##
#.......#........####.....#.......#.....#...##...#
#........#.......#.....##.#...##......#..##...####
#..........#####.#....#...#.........#............#
#....###...#...####...#####.......#........#.#.#.#
#...#...#..##.......########...####......#.......#
#.........######..#...........#...#....##..A.....#
#.###....##.........######..#....####........#...#
#.......#.....A.....#.......#....................#
#..##########......#....B..#######################
#.........#.....####......#..#....#...#.B.#...#..#
#......##...##.................#..A.#...#...#..<.#
##################################################
