##################################################
#@..#..#..................#................##....#
#..#......#...........#.......##......#..........#
#.#...##...........##...................#........#
#.......##.....##.......##.....###########.......#
#............#....#.##.....##.........#..........#
#.......#.##............................##.......#
#........#.....#....#######.....##..#....#####..##
#.......#........####.....#.......#.....#...##...#
#........#.......#.....##.#...##......#..##...####
#..........#####.#....#...#.........#............#
#....###...#...####...#####.......#........#.#.#.#
#...#...#..##.......########...####......#.......#
#.........######..#...........#...#....##........#
#.###....##.........######..#....####........#...#
#.......#...........#.......#....................#
#..##########......#.......#######################
#.........#.....####......#..#....#...#...#...#..#
#......##...##.................#....#...#...#....#
##################################################
